000011000011000
100000000000000
100000000000000
100000000000000
100000000000000
000000000010000
000000000010000
000000000010000
000000000010000
000000000010000
000000000010000
000000000010000
000000000010000
000000000010000
000000000010000
110011111110000
000000000000000
000000000000000
000000000000000
000000000000000