000000000000000
000000000000000
000000000000000
111000111111000
000000000001000
000000000001000
000000000001000
000000000001000
000111111111000
000000000000000
000000000000000
000000000000000
111000110001000
000000000001000
000000000001000
000000000001000
000111111111000
000000000000000
000000000000000
000000000000000