000000010000000
000000000000000
000000000000000
111000000000000
001000010000000
000000001000001
000000000100000
000000000010000
001000000010000
111000000010000
000000000000000
000000000000000
000000000000001
000000000000001
000011111100001
000000000000000
000000000000000
000000000000000
000000000000000
000000011100000