000000110000000
000000100000000
000000100000000
001000000000000
001000000000001
000000000000000
000000000010000
000000000010000
111100000001000
100000000001000
100000000000000
000000000000000
000000000000000
000000000000111
000111000000000
000001000000000
000000000000000
000000000011000
000000000011000
000000000011000